race	race
gender	gender
age	age
admission_type_id	adm_type
discharge_disposition_id	dd_id
admission_source_id	as_id
time_in_hospital	time_in_hosp
num_lab_procedures	lab_proc
num_procedures	num_proc
num_medications	num_med
number_outpatient	num_op
number_emergency	num_emer
number_inpatient	num_ip
number_diagnoses	num_diag
max_glu_serum	max_gs
A1Cresult	a1c
metformin	met
repaglinide	rep
nateglinide	nat
chlorpropamide	chl
glimepiride	glim
acetohexamide	ahm
glipizide	glip
glyburide	glyb
tolbutamide	tba
pioglitazone	pga
rosiglitazone	rgz
acarbose	acar
miglitol	mig
troglitazone	tgz
tolazamide	tzm
examide	emd
citoglipton	cgp
insulin	ins
glyburide-metformin	gmfm
glipizide-metformin	gmfn
glimepiride-pioglitazone	gpgz
metformin-rosiglitazone	mrgz
metformin-pioglitazone	mpgz
change	change
diabetesMed	dm
readmitted	readmitted
